filename, language, YAML, hosts, Ignore, comment, blank, total
bootstrap-playbooks/roles/config-builder/tasks/main.yml, YAML, 62, 0, 0, 0, 12, 74
bootstrap-playbooks/roles/config-builder/vars/main.yml, YAML, 343, 0, 0, 1, 6, 350
bootstrap-playbooks/roles/config-builder/vars/vault.yml, YAML, 10, 0, 0, 0, 1, 11
bootstrap-playbooks/site.yml, YAML, 5, 0, 0, 0, 2, 7
config.sut.yaml, YAML, 214, 0, 0, 1, 6, 221
config.yaml, YAML, 343, 0, 0, 1, 6, 350
inventory/hosts, hosts, 0, 6, 0, 0, 3, 9
playbooks/group_vars/all/vars.yml, YAML, 101, 0, 0, 0, 2, 103
playbooks/group_vars/all/vault.yml, YAML, 10, 0, 0, 0, 1, 11
playbooks/group_vars/eos/vars.yml, YAML, 2, 0, 0, 0, 2, 4
playbooks/group_vars/eos_infra/vars.yml, YAML, 2, 0, 0, 0, 2, 4
playbooks/group_vars/eos_infra2/vars.yml, YAML, 2, 0, 0, 0, 2, 4
playbooks/host_vars/eos-kisti-01.sdfarm.kr/vars.yml, YAML, 154, 0, 0, 0, 2, 156
playbooks/host_vars/eos-kisti-02.sdfarm.kr/vars.yml, YAML, 22, 0, 0, 0, 2, 24
playbooks/host_vars/eos-kisti-03.sdfarm.kr/vars.yml, YAML, 22, 0, 0, 0, 2, 24
playbooks/paralleling-upgrade.yml, YAML, 5, 0, 0, 0, 1, 6
playbooks/requirements-check.yml, YAML, 57, 0, 0, 0, 2, 59
playbooks/roles/baseshare/handlers/main.yml, YAML, 22, 0, 0, 0, 9, 31
playbooks/roles/chrony/tasks/main.yml, YAML, 54, 0, 0, 0, 9, 63
playbooks/roles/cockpit/tasks/main.yml, YAML, 64, 0, 0, 0, 12, 76
playbooks/roles/docker/tasks/main.yml, YAML, 126, 0, 0, 1, 20, 147
playbooks/roles/eos-docker-builder/tasks/main.yml, YAML, 27, 0, 0, 0, 5, 32
playbooks/roles/eos-docker-fst/tasks/main.yml, YAML, 136, 0, 0, 0, 23, 159
playbooks/roles/eos-docker-krb/tasks/main.yml, YAML, 148, 0, 0, 0, 25, 173
playbooks/roles/eos-docker-mgm/tasks/main.yml, YAML, 142, 0, 0, 0, 24, 166
playbooks/roles/eos-docker-mq/tasks/main.yml, YAML, 134, 0, 0, 0, 23, 157
playbooks/roles/eos-docker-proxy/tasks/main.yml, YAML, 134, 0, 0, 0, 23, 157
playbooks/roles/eos-docker-qdb/tasks/main.yml, YAML, 133, 0, 0, 0, 23, 156
playbooks/roles/firewalld/tasks/main.yml, YAML, 28, 0, 0, 0, 6, 34
playbooks/roles/network/tasks/main.yml, YAML, 93, 0, 0, 0, 15, 108
playbooks/site.yml, YAML, 34, 0, 0, 0, 3, 37
playbooks/ssh-copy-id.yml, YAML, 7, 0, 0, 0, 1, 8
playbooks/ssh-key-scan.yml, YAML, 25, 0, 0, 0, 1, 26
playbooks/tasks/upgrade.yml, YAML, 36, 0, 0, 0, 5, 41
ref/sample-docker/.gitignore, Ignore, 0, 0, 1, 0, 1, 2
ref/sample-docker/.gitlab-ci.yml, YAML, 17, 0, 0, 0, 1, 18
Total, -, 2714, 6, 1, 4, 283, 3008